------------------------------------
|                                  |
|           #                      |
|                                  |
|                                  |
|                                  |
|                                  |
|                                  |
|                                  |
|                                  |
|                                  |
|                                  |
|                           *      |
|                                  |
|                                  |
------------------------------------