-------------------
|                 |
|           #     |
|                 |
|                 |
|                 |
|               * |
|                 |
|                 |
-------------------