-------------------------
|                       |
|    #                  |
|                       |
|                       |
|                       |
|                       |
|                       |
|               *       |
|                       |
|                       |
-------------------------