-------------------
|                 |
|                 |
|   #             |
|                 |
|                 |
|                 |
|            *    |
|                 |
-------------------