----------------------
|        |  |        |
|        |  |     #  |
|     ----------     |
|     |              |
|                    |
|              |     |
|     ----------     |
|        |  |        |
|    *   |  |        |
----------------------