-----------------
|               |
|   #           |
|               |
|               |
|            *  |
|               |
-----------------