-------------------------
|                       |
|                       |
|    *                  |
|                       |
|                       |
|                       |
|                       |
|                       |
|                     # |
|                       |
-------------------------