--------
|    # |
|      |
|*     |
--------