----------------------
|     |        |     |
|     |        |     |
|     |        |     |
|     ----------   * |
| #                  | 
|     ----------     |
|     |        |     |
|     |        |     |
|     |        |     |
----------------------