----------------------
|                    |
|    *               |
|     ----------     |
|     |        |     |
|     |        |     |
|     ----------     |
|                  # |
|                    |
----------------------